5 1 1 1 1 1 1 1 1 1 1 1 1 1 1 6
3 0 14 2 0 0 0 0 0 0 0 0 0 0 0 4
3 0 0 0 0 0 0 0 0 0 0 0 0 0 0 9
3 0 12 13 12 0 0 11 13 12 13 12 13 12 0 4
3 0 0 0 0 0 0 0 0 0 0 0 0 0 0 4
3 0 11 13 12 0 0 10 13 11 13 12 13 11 0 4
3 0 0 0 0 0 0 0 0 0 0 0 0 0 0 4
3 0 0 0 0 0 0 0 0 0 0 0 0 0 0 4
3 0 0 0 0 0 0 0 0 0 0 0 0 0 0 4
3 0 12 13 12 0 0 12 13 12 13 11 13 12 0 4
3 0 0 0 0 0 0 0 0 0 0 0 0 0 0 4
3 2 12 13 12 2 2 12 13 12 13 12 13 12 2 4